WE ./texture/west_texture.xpm
NO ./texture/north_texture.xpm
SO ./texture/south_texture.xpm
EA ./texture/east_texture.xpm
C 0,0,0
F 255,255,255

111111111111111111111111111111111111111
110010000000000000000000000000000000001
100000000100000000100000000000000000001
100001001000000000000000000000000000001
100000001000000000000010000000000000001
100001001000000000000000000000000000001
100000000000100010000000000000000000001
100001S00001 10000000111000000000000001
100000000001100000001 10000100000000011
100001001001000000000011100000000000001
100000000000000000000001000000000000001
100000100010000001000000000001000000001
111111111111111111111111111111111111111