WE ./path_to_the_west_texture.xpm
NO ./path_to_the_north_texture.xpm
SO ./path_to_the_south_texture.xpm
EA ./path_to_the_east_texture.xpm

C 225,0,0
F 255,255,255

111111111111111111
100000000000000001
1000000000N0000001
100001111100000001
100000000000000001
100000011110000001
100000011110000001
111111111111111111
