WE ./path_to_the_west_texture.xpm
NO ./path_to_the_north_texture.xpm
SO ./path_to_the_south_texture.xpm
EA ./path_to_the_east_texture.xpm

C 225,0,0
F 255,255,252

111111111111111111
100000000000000001
100000000000000001
100001000000N00001
100010000000000001
100000000011100001
100000000000000001
111111111111111111
