WE ./texture/west_texture.xpm
NO ./texture/north_texture.xpm
SO ./texture/south_texture.xpm
EA ./texture/east_texture.xpm

C 100,255,255
F 000,0,0

111111111111111111111111111111111111111
110010000000000000000000000000000000001
100000000100000000100000000000000000001
100001001000000000000000000000000000001
100000001000000000000010000000000000001
100001001000000000000000000000000000001
100000000000000010000000000000000000001
100001000000000000000111000000000000001
100000000000000000001 10000100000000011
10000100N001000000000011100000000000001
100000000000000000000001000000000000001
100000100010000001000000000001000000001
111111111111111111111111111111111111111