WE ./path_to_the_west_texture.xpm
NO ./path_to_the_north_texture.xpm
SO ./path_to_the_south_texture.xpm
EA ./path_to_the_east_texture.xpm
C 140,50,60
F 255,255,244

111111111111111111111111111111111111111
100010000000000000000000000000000000001
100000000100000000100000000000000000001
100001001000000000000000000000000000001
100000001000000000000010000000000000001
100001001000000000000000000000000000001
100000000000000010000000000000000000001
100001000000000000000111000000000000001
1000000000000000000001 1000010000000001
10000100N010000000000111000000000000001
100000000000000000000001000000000000001
100000100010000001000000000001000000001
111111111111111111111111111111111111111